r.........+........r
r..................r
r..................r
r..................r
r..................r
r..................r
r........OYR.......r
r..................r
r...RBG.......BGO..r
r..................r
rrbbggooyyrbgoyrbgoy