....................
....................
....................
.........+..........
....................
....................
.........OYR........
....................
....RBG.......BGO...
....................
rrbbggooyyrbgoyrbgoy