....................
...........e........
.........rbgoy......
.b.e................
.ryoGBR.............
..........S.........
.........OYR........
.....s.........S....
....RBG...g...BGO...
.+........b.......e.
rrbbggooyyrbgoyrbgoy